ZIP	Estimate; Total:	Estimate; Male:	Estimate; Male: - 65 to 69 years:	Estimate; Male: - 70 to 74 years:	Estimate; Male: - 75 years and over:	Estimate; Female:	Estimate; Female: - 65 to 69 years:	Estimate; Female: - 70 to 74 years:	Estimate; Female: - 75 years and over:	 Male: Age: 65 and over	 Female: Age: 65 and over	 Overall People Age: 65 and over
90001	57702	28712	830	528	846	28990	1042	748	1066	2204	2856	5060
90002	51816	24237	699	546	539	27579	911	656	1113	1784	2680	4464
90003	103994	49282	1678	1024	1544	54712	1657	1270	2257	4246	5184	9430
90004	67407	33789	1258	859	1418	33618	1559	1186	1991	3535	4736	8271
90005	66270	32796	1276	1086	1273	33474	1669	1336	2215	3635	5220	8855
90006	79185	40868	1565	1217	1112	38317	1691	1320	2265	3894	5276	9170
90007	69546	33863	839	490	881	35683	1067	632	1785	2210	3484	5694
90008	43573	18880	917	759	1691	24693	1517	1266	2654	3367	5437	8804
90009	0	0	0	0	0	0	0	0	0	0	0	0
90010	42779	20710	819	580	886	22069	1015	912	1378	2285	3305	5590
90011	88324	44319	926	578	1016	44005	1215	767	1643	2520	3625	6145
90012	48963	28618	1043	602	1430	20345	1098	673	2246	3075	4017	7092
90013	25529	15275	753	296	925	10254	426	315	1414	1974	2155	4129
90014	18366	11692	547	187	389	6674	191	197	369	1123	757	1880
90015	40864	21651	693	502	814	19213	745	463	1541	2009	2749	4758
90016	77134	35975	1408	974	1871	41159	2200	1675	3197	4253	7072	11325
90017	39453	20854	485	407	711	18599	519	687	1440	1603	2646	4249
90018	71674	33737	1389	918	1446	37937	1655	1273	2981	3753	5909	9662
90019	80277	39432	1817	1103	1755	40845	1929	1586	2894	4675	6409	11084
90020	66599	32640	1247	595	1453	33959	1468	1105	2051	3295	4624	7919
90021	11306	7451	444	98	257	3855	146	8	129	799	283	1082
90022	75633	36560	1249	1051	2269	39073	1854	1682	3264	4569	6800	11369
90023	56982	29011	945	755	1257	27971	1252	786	1675	2957	3713	6670
90024	52565	25281	654	691	1570	27284	930	545	2229	2915	3704	6619
90025	69980	34049	1489	1038	2019	35931	1868	1457	2977	4546	6302	10848
90026	82143	41335	1619	1143	1787	40808	1826	1408	2868	4549	6102	10651
90027	62143	30910	1431	1084	1596	31233	1639	1258	2706	4111	5603	9714
90028	62188	33878	920	654	1330	28310	1276	1010	1905	2904	4191	7095
90029	72575	36885	1604	1053	1420	35690	1697	1186	2761	4077	5644	9721
90030	1827	821	95	26	54	1006	131	15	135	175	281	456
90031	47700	23737	1094	697	1234	23963	1176	821	2251	3025	4248	7273
90032	62439	30365	1270	989	1454	32074	1863	1089	2876	3713	5828	9541
90033	47381	23253	784	559	1253	24128	814	771	2016	2596	3601	6197
90034	65978	32965	1123	956	1444	33013	1650	1009	1983	3523	4642	8165
90035	42231	19762	1104	662	1348	22469	1268	1008	2342	3114	4618	7732
90036	58883	28267	992	712	1773	30616	1292	1080	2746	3477	5118	8595
90037	72434	35263	819	587	1042	37171	995	768	1813	2448	3576	6024
90038	48310	25058	712	643	1184	23252	1074	1156	1736	2539	3966	6505
90039	39250	19948	1039	681	1246	19302	1056	711	1495	2966	3262	6228
90040	40428	20186	621	602	791	20242	826	729	1185	2014	2740	4754
90041	34962	16615	880	807	1267	18347	1029	892	2057	2954	3978	6932
90042	73806	35234	1861	1025	1902	38572	2020	1378	3045	4788	6443	11231
90043	40581	18465	825	663	1207	22116	1482	981	2145	2695	4608	7303
90044	100528	45999	1807	1142	2145	54529	2268	1836	3520	5094	7624	12718
90045	66046	30840	1426	852	1814	35206	1778	1018	2972	4092	5768	9860
90046	77656	41808	1804	1152	2350	35848	1609	1219	3407	5306	6235	11541
90047	72338	32789	1500	1111	2182	39549	2148	1919	3414	4793	7481	12274
90048	32182	15618	643	341	907	16564	787	615	1466	1891	2868	4759
90049	51325	24052	1882	1405	2811	27273	2060	1477	3075	6098	6612	12710
90050	2855	1261	75	37	66	1594	72	75	140	178	287	465
90051	1827	821	95	26	54	1006	131	15	135	175	281	456
90052	2255	1149	0	14	25	1106	35	34	40	39	109	148
90053	991	895	22	12	13	96	12	1	8	47	21	68
90054	1827	821	95	26	54	1006	131	15	135	175	281	456
90055	2996	1638	7	18	123	1358	17	95	153	148	265	413
90056	30876	13784	609	455	1035	17092	1127	634	1917	2099	3678	5777
90057	54413	28787	915	805	1043	25626	1027	941	2087	2763	4055	6818
90058	28745	14745	435	258	274	14000	352	318	581	967	1251	2218
90059	61988	28078	887	589	896	33910	1192	835	1410	2372	3437	5809
90060	1827	821	95	26	54	1006	131	15	135	175	281	456
90061	53688	24535	862	582	1123	29153	1106	968	1802	2567	3876	6443
90062	49016	23319	728	687	1231	25697	1154	1005	2047	2646	4206	6852
90063	65433	32099	1370	846	1476	33334	1556	1108	2193	3692	4857	8549
90064	52705	24896	1299	908	1696	27809	1277	1312	2529	3903	5118	9021
90065	56205	27992	1192	795	1878	28213	1549	1268	2439	3865	5256	9121
90066	77893	38849	1761	1359	2116	39044	2354	1378	2710	5236	6442	11678
90067	12268	5619	380	241	733	6649	389	367	1035	1354	1791	3145
90068	28253	15480	569	457	847	12773	653	388	995	1873	2036	3909
90069	27991	16686	688	494	793	11305	477	363	903	1975	1743	3718
90070	2307	1019	17	47	46	1288	55	36	77	110	168	278
90071	5473	2834	110	60	446	2639	118	162	799	616	1079	1695
90072	3492	1741	73	47	14	1751	164	26	41	134	231	365
90073	948	786	23	22	76	162	16	4	29	121	49	170
90074	2996	1638	7	18	123	1358	17	95	153	148	265	413
90075	3670	1725	45	40	146	1945	57	86	53	231	196	427
90076	3670	1725	45	40	146	1945	57	86	53	231	196	427
90077	26877	12473	494	528	1220	14404	736	511	1442	2242	2689	4931
90078	3171	1734	34	20	138	1437	53	61	117	192	231	423
90079	4049	1947	0	65	98	2102	27	29	158	163	214	377
90081	2996	1638	7	18	123	1358	17	95	153	148	265	413
90082	4085	2098	99	12	9	1987	20	30	111	120	161	281
90083	5293	2531	91	40	40	2762	122	2	176	171	300	471
90084	2996	1638	7	18	123	1358	17	95	153	148	265	413
90086	1827	821	95	26	54	1006	131	15	135	175	281	456
90087	1827	821	95	26	54	1006	131	15	135	175	281	456
90089	9630	4695	41	53	87	4935	38	25	138	181	201	382
90090	119	62	1	0	8	57	5	13	4	9	22	31
90091	3569	1770	88	100	73	1799	97	109	259	261	465	726
90093	3171	1734	34	20	138	1437	53	61	117	192	231	423
90094	6596	3137	75	16	67	3459	122	92	54	158	268	426
90095	11519	5130	0	0	0	6389	0	0	0	0	0	0
90201	85667	42327	1215	1082	1151	43340	1632	953	2142	3448	4727	8175
90202	3432	1626	51	10	45	1806	67	10	74	106	151	257
90209	5326	2429	240	102	306	2897	329	165	513	648	1007	1655
90210	40160	19974	1646	1176	2132	20186	1732	1111	2449	4954	5292	10246
90211	19880	8917	636	239	868	10963	593	497	1266	1743	2356	4099
90212	26626	12041	1087	398	1124	14585	861	641	1756	2609	3258	5867
90213	5326	2429	240	102	306	2897	329	165	513	648	1007	1655
90220	44420	21062	719	486	858	23358	1164	1155	1583	2063	3902	5965
90221	59624	28708	1126	580	867	30916	1318	878	1332	2573	3528	6101
90222	51474	24610	905	571	775	26864	907	760	1242	2251	2909	5160
90223	3045	1349	42	21	62	1696	67	40	78	125	185	310
90224	3789	1929	67	41	101	1860	59	62	80	209	201	410
90230	50594	23796	1343	797	1523	26798	1924	1009	2473	3663	5406	9069
90231	4937	2354	254	125	135	2583	252	164	334	514	750	1264
90232	32521	15780	677	414	888	16741	991	644	1071	1979	2706	4685
90239	3819	1784	45	58	37	2035	29	86	68	140	183	323
90240	39826	19139	719	684	1160	20687	1232	667	1576	2563	3475	6038
90241	54088	25744	1065	777	1300	28344	1251	935	2059	3142	4245	7387
90242	44363	21168	830	499	902	23195	852	764	1157	2231	2773	5004
90245	16671	8386	285	189	386	8285	366	239	653	860	1258	2118
90247	59112	28405	1163	1006	2157	30707	1390	1341	3255	4326	5986	10312
90248	65536	30955	1555	987	2445	34581	1669	1714	3819	4987	7202	12189
90249	43379	20116	1003	640	1349	23263	1271	1175	2051	2992	4497	7489
90250	92146	44277	1838	1179	1629	47869	1885	1567	2644	4646	6096	10742
90251	4507	2317	114	12	88	2190	113	55	96	214	264	478
90254	26773	13591	758	542	701	13182	774	347	955	2001	2076	4077
90255	78314	38831	1357	853	1337	39483	1511	1187	2076	3547	4774	8321
90260	37230	18179	770	395	743	19051	934	615	1328	1908	2877	4785
90261	2985	1572	45	38	64	1413	51	65	170	147	286	433
90262	58492	27855	939	495	908	30637	964	676	1357	2342	2997	5339
90263	3735	1645	98	10	49	2090	47	21	54	157	122	279
90264	6110	2886	290	100	389	3224	299	260	342	779	901	1680
90265	27280	13277	1068	611	1176	14003	1051	699	1430	2855	3180	6035
90266	28535	13800	952	667	1068	14735	1029	488	1353	2687	2870	5557
90267	2078	1030	113	52	107	1048	89	25	92	272	206	478
90270	25540	12807	376	214	326	12733	334	340	604	916	1278	2194
90272	22043	10308	982	781	1381	11735	910	815	1444	3144	3169	6313
90274	47500	22739	1871	1505	3762	24761	2049	1721	4278	7138	8048	15186
90275	53556	25096	1887	1712	3935	28460	2097	2099	4497	7534	8693	16227
90277	38202	18656	1052	846	1210	19546	1081	710	1823	3108	3614	6722
90278	53281	26314	1325	800	1275	26967	1531	880	1953	3400	4364	7764
90280	105453	51591	1721	1272	1619	53862	2188	1480	2963	4612	6631	11243
90290	12653	6191	429	333	500	6462	480	319	598	1262	1397	2659
90291	30388	15589	803	410	693	14799	781	458	962	1906	2201	4107
90292	29401	14816	839	524	1066	14585	945	586	1176	2429	2707	5136
90293	15282	7554	418	194	413	7728	606	154	513	1025	1273	2298
90294	2740	1462	42	30	30	1278	19	14	55	102	88	190
90295	8467	4581	291	147	249	3886	218	182	101	687	501	1188
90296	2884	1546	68	66	61	1338	118	73	31	195	222	417
90301	43394	20454	882	674	682	22940	1203	592	1264	2238	3059	5297
90302	31465	14192	669	346	794	17273	867	492	1376	1809	2735	4544
90303	37087	17628	685	449	438	19459	910	627	812	1572	2349	3921
90304	45629	22386	849	474	612	23243	899	595	1023	1935	2517	4452
90305	16363	7167	410	359	422	9196	705	378	801	1191	1884	3075
90306	1730	699	61	44	119	1031	102	104	171	224	377	601
90307	1730	699	61	44	119	1031	102	104	171	224	377	601
90308	1730	699	61	44	119	1031	102	104	171	224	377	601
90309	5083	2395	45	58	43	2688	96	44	149	146	289	435
90310	1774	825	50	49	50	949	35	35	84	149	154	303
90401	24871	12522	586	289	976	12349	652	544	1425	1851	2621	4472
90402	24604	11310	861	673	1339	13294	1150	910	1404	2873	3464	6337
90403	37040	17611	1065	612	1412	19429	1212	1128	1948	3089	4288	7377
90404	32814	16113	668	350	991	16701	921	764	1686	2009	3371	5380
90405	45283	22329	1298	658	1233	22954	1283	936	2167	3189	4386	7575
90406	4092	2128	75	29	255	1964	122	85	254	359	461	820
90408	4300	2003	184	54	79	2297	122	80	212	317	414	731
90409	5614	2614	162	47	147	3000	189	144	230	356	563	919
90501	56832	27663	1128	906	1524	29169	1633	1113	2357	3558	5103	8661
90502	24888	11905	671	476	903	12983	713	628	1499	2050	2840	4890
90503	47898	23376	1102	875	1596	24522	1417	1233	2516	3573	5166	8739
90504	49731	24524	1369	825	1556	25207	1286	1246	2353	3750	4885	8635
90505	55574	26481	1330	1071	2616	29093	1763	1301	3686	5017	6750	11767
90506	4216	1923	156	54	141	2293	149	159	275	351	583	934
90507	5013	2542	52	112	58	2471	183	146	127	222	456	678
90508	5013	2542	52	112	58	2471	183	146	127	222	456	678
90510	5490	2632	100	71	165	2858	172	146	231	336	549	885
90601	54488	26276	1186	916	1705	28212	1324	1057	2878	3807	5259	9066
90602	47323	22767	997	657	1599	24556	983	777	2340	3253	4100	7353
90603	30965	15042	1016	523	1142	15923	1004	544	1420	2681	2968	5649
90604	40853	19767	749	611	1093	21086	1049	811	1657	2453	3517	5970
90605	56240	26921	1176	771	1524	29319	1318	938	2205	3471	4461	7932
90606	43615	21141	945	643	1201	22474	1020	778	2251	2789	4049	6838
90607	2919	1501	52	24	116	1418	75	79	146	192	300	492
90608	3000	1547	89	71	181	1453	39	44	239	341	322	663
90609	3416	1772	95	97	124	1644	128	57	125	316	310	626
90623	3014	1590	108	117	228	1424	126	101	232	453	459	912
90630	3617	1791	50	22	182	1826	38	115	120	254	273	527
90631	13553	6586	551	372	661	6967	590	298	834	1584	1722	3306
90637	4069	2011	92	82	105	2058	111	66	174	279	351	630
90638	50647	24433	1341	855	1751	26214	1492	1310	2985	3947	5787	9734
90639	5410	2589	152	28	110	2821	85	50	258	290	393	683
90640	70203	33755	1423	1428	2539	36448	2072	1714	3877	5390	7663	13053
90650	83055	41327	1505	1238	2068	41728	2248	1642	2975	4811	6865	11676
90651	5072	2557	187	86	240	2515	235	207	391	513	833	1346
90652	6039	3043	86	119	121	2996	148	90	136	326	374	700
90660	58528	27831	1268	943	1760	30697	1881	1311	2906	3971	6098	10069
90662	3626	1706	37	45	68	1920	49	32	218	150	299	449
90670	33876	16635	634	554	919	17241	828	586	1632	2107	3046	5153
90701	24150	11957	688	514	913	12193	658	595	1375	2115	2628	4743
90702	5050	2683	131	126	165	2367	82	103	356	422	541	963
90703	69875	33921	2072	1420	2750	35954	2329	2134	3408	6242	7871	14113
90704	439	259	0	0	0	180	0	0	17	0	17	17
90706	66421	31783	1192	648	1331	34638	1545	1240	2121	3171	4906	8077
90707	2829	1279	56	29	42	1550	92	48	119	127	259	386
90710	29624	13754	717	396	924	15870	884	633	1048	2037	2565	4602
90711	4203	1970	72	32	80	2233	74	62	172	184	308	492
90712	31953	15121	666	596	818	16832	626	647	1309	2080	2582	4662
90713	34266	16573	867	459	890	17693	706	570	1634	2216	2910	5126
90714	4203	1970	72	32	80	2233	74	62	172	184	308	492
90715	19186	9148	316	245	547	10038	396	422	595	1108	1413	2521
90716	18838	9027	280	244	417	9811	424	322	572	941	1318	2259
90717	48756	22864	1281	910	1942	25892	1404	1133	2643	4133	5180	9313
90723	51243	25226	1025	524	747	26017	941	652	1145	2296	2738	5034
90731	60639	30372	1251	881	1767	30267	1712	1199	2145	3899	5056	8955
90732	38743	18221	1058	983	2094	20522	1394	1244	2624	4135	5262	9397
90733	3974	2180	40	58	73	1794	51	45	143	171	239	410
90734	5777	2526	222	226	379	3251	241	242	402	827	885	1712
90744	45266	22396	786	448	835	22870	882	571	1251	2069	2704	4773
90745	50762	24112	1334	832	1551	26650	1447	1154	2423	3717	5024	8741
90746	33190	15704	660	756	1178	17486	1282	1120	1761	2594	4163	6757
90747	4631	2216	101	79	104	2415	263	204	152	284	619	903
90748	3162	1609	9	56	121	1553	89	37	95	186	221	407
90749	5693	2725	203	67	186	2968	170	112	309	456	591	1047
90755	18444	9017	391	185	315	9427	390	199	515	891	1104	1995
90801	4656	2578	123	61	38	2078	50	59	94	222	203	425
90802	37915	19834	883	462	718	18081	678	488	930	2063	2096	4159
90803	45617	22798	1799	953	1112	22819	1511	854	1759	3864	4124	7988
90804	67332	33586	1499	913	1119	33746	1418	764	1736	3531	3918	7449
90805	89128	42459	2013	1076	1492	46669	1831	1488	2140	4581	5459	10040
90806	57764	28093	1013	614	1049	29671	1091	923	1607	2676	3621	6297
90807	36624	17766	1131	721	1018	18858	925	876	1996	2870	3797	6667
90808	38753	18964	1068	585	1317	19789	921	777	1966	2970	3664	6634
90809	1851	864	70	42	73	987	55	31	197	185	283	468
90810	36856	17473	889	550	985	19383	895	1101	1530	2424	3526	5950
90813	71791	35747	1226	677	1014	36044	1219	677	1461	2917	3357	6274
90814	26760	13537	1068	568	608	13223	824	415	1071	2244	2310	4554
90815	41063	19868	1096	828	1369	21195	1108	807	2129	3293	4044	7337
90822	1009	997	18	46	10	12	0	0	0	74	0	74
90831	4934	2744	191	118	78	2190	218	114	80	387	412	799
90832	4934	2744	191	118	78	2190	218	114	80	387	412	799
90833	4934	2744	191	118	78	2190	218	114	80	387	412	799
90834	4934	2744	191	118	78	2190	218	114	80	387	412	799
90835	4934	2744	191	118	78	2190	218	114	80	387	412	799
90840	2142	869	0	0	0	1273	0	0	0	0	0	0
90844	4934	2744	191	118	78	2190	218	114	80	387	412	799
90846	4755	2250	103	105	117	2505	155	36	337	325	528	853
90853	2654	1152	87	32	40	1502	95	54	124	159	273	432
90895	3342	1552	71	28	92	1790	44	103	134	191	281	472
91001	48750	23594	1268	875	1598	25156	1608	1264	2555	3741	5427	9168
91003	3807	1824	161	111	126	1983	222	97	172	398	491	889
91006	52906	24531	1583	898	1945	28375	1560	1303	3032	4426	5895	10321
91007	44590	20350	1291	616	1767	24240	1722	1433	2773	3674	5928	9602
91008	13335	6029	367	353	524	7306	509	327	923	1244	1759	3003
91009	4117	1670	119	66	200	2447	158	152	478	385	788	1173
91010	28860	13060	646	503	911	15800	935	811	1763	2060	3509	5569
91011	37479	18007	1261	965	1562	19472	1235	935	1830	3788	4000	7788
91012	3587	1810	125	70	98	1777	106	115	97	293	318	611
91016	49836	24195	1356	857	1537	25641	1502	953	1979	3750	4434	8184
91017	5529	2831	106	32	59	2698	168	44	83	197	295	492
91020	20300	9154	471	329	684	11146	605	341	1146	1484	2092	3576
91021	4642	2115	118	67	73	2527	144	54	102	258	300	558
91023	129	47	16	0	0	82	4	0	0	16	4	20
91024	16033	7523	458	447	678	8510	641	441	885	1583	1967	3550
91025	5675	2638	90	195	187	3037	268	139	279	472	686	1158
91030	39661	18862	1159	939	1367	20799	995	1112	1897	3465	4004	7469
91031	4117	1846	150	142	113	2271	153	109	157	405	419	824
91040	27693	13884	845	492	976	13809	1043	590	1289	2313	2922	5235
91041	5431	3107	179	70	245	2324	271	118	299	494	688	1182
91042	34045	16472	692	585	967	17573	1248	723	1282	2244	3253	5497
91043	4931	2541	26	0	102	2390	215	55	117	128	387	515
91046	7192	3166	148	105	289	4026	258	139	523	542	920	1462
91066	5422	2550	124	14	114	2872	113	44	103	252	260	512
91077	4187	1768	162	0	94	2419	156	121	278	256	555	811
91101	33110	15975	414	125	855	17135	685	671	1837	1394	3193	4587
91102	4143	2160	32	18	10	1983	66	15	63	60	144	204
91103	42308	20666	973	717	1109	21642	1132	863	1897	2799	3892	6691
91104	53672	25490	1348	699	1520	28182	1451	1166	3013	3567	5630	9197
91105	33951	16405	1117	1048	1572	17546	1206	1133	2046	3737	4385	8122
91106	42404	20826	952	436	1291	21578	962	1041	1921	2679	3924	6603
91107	49884	24162	1556	1146	1789	25722	1701	1330	2752	4491	5783	10274
91108	24108	11728	708	524	1065	12380	575	740	1274	2297	2589	4886
91109	4143	2160	32	18	10	1983	66	15	63	60	144	204
91114	2715	1241	48	21	88	1474	89	68	190	157	347	504
91115	2554	1305	69	65	122	1249	86	44	167	256	297	553
91116	2468	1264	7	0	38	1204	32	30	58	45	120	165
91117	3039	1461	113	82	92	1578	93	107	149	287	349	636
91118	4703	2185	118	175	233	2518	160	178	303	526	641	1167
91121	3039	1461	113	82	92	1578	93	107	149	287	349	636
91123	2554	1305	69	65	122	1249	86	44	167	256	297	553
91124	1458	693	22	15	58	765	40	57	52	95	149	244
91125	5578	3030	124	12	188	2548	37	118	170	324	325	649
91126	5578	3030	124	12	188	2548	37	118	170	324	325	649
91129	2554	1305	69	65	122	1249	86	44	167	256	297	553
91182	2529	1219	9	16	34	1310	38	0	90	59	128	187
91184	2554	1305	69	65	122	1249	86	44	167	256	297	553
91185	4614	2113	108	85	122	2501	159	172	225	315	556	871
91188	1458	693	22	15	58	765	40	57	52	95	149	244
91189	2946	1408	107	143	206	1538	160	172	324	456	656	1112
91199	1458	693	22	15	58	765	40	57	52	95	149	244
91201	45640	21656	1026	732	2010	23984	1395	1039	2595	3768	5029	8797
91202	32896	15186	851	782	1369	17710	1031	1002	2146	3002	4179	7181
91203	24319	11657	618	465	882	12662	716	677	1397	1965	2790	4755
91204	39559	18726	847	780	1036	20833	930	853	2450	2663	4233	6896
91205	52533	24945	1144	1031	1724	27588	1551	1376	3013	3899	5940	9839
91206	45591	21969	1233	1050	2002	23622	1629	1238	2834	4285	5701	9986
91207	19502	9232	358	491	939	10270	722	556	1262	1788	2540	4328
91208	32905	15758	852	763	1542	17147	994	711	1853	3157	3558	6715
91209	3333	1596	61	117	145	1737	63	107	465	323	635	958
91210	3606	1865	74	66	133	1741	113	31	174	273	318	591
91214	38003	17978	1080	862	1284	20025	1143	969	1886	3226	3998	7224
91221	5721	2954	77	67	295	2767	32	147	332	439	511	950
91222	4510	2141	187	47	117	2369	232	79	174	351	485	836
91224	4561	2175	107	89	139	2386	92	82	129	335	303	638
91225	3647	1750	71	42	89	1897	55	86	84	202	225	427
91226	3982	1929	75	96	59	2053	178	48	209	230	435	665
91301	27840	13843	914	657	739	13997	897	648	710	2310	2255	4565
91302	37554	18007	1141	895	1463	19547	1288	1096	1650	3499	4034	7533
91303	38247	19651	677	546	762	18596	685	655	1381	1985	2721	4706
91304	62592	30414	1342	1059	1509	32178	1754	1028	2916	3910	5698	9608
91305	4145	2023	59	79	69	2122	68	33	133	207	234	441
91306	54955	27405	1012	782	1311	27550	1155	989	1893	3105	4037	7142
91307	35745	17174	1088	657	1181	18571	1150	762	1927	2926	3839	6765
91308	6027	2847	161	48	306	3180	162	167	278	515	607	1122
91309	4145	2023	59	79	69	2122	68	33	133	207	234	441
91310	6051	5979	26	7	0	72	0	0	0	33	0	33
91311	58833	28657	1397	1166	2150	30176	2255	1250	2896	4713	6401	11114
91313	3924	1996	93	167	141	1928	149	89	181	401	419	820
91316	41938	19607	1112	1120	1616	22331	1686	1028	2101	3848	4815	8663
91321	50627	25057	1187	773	1403	25570	1625	989	2482	3363	5096	8459
91322	4490	2398	72	16	51	2092	81	56	62	139	199	338
91324	56356	28516	1374	1034	2184	27840	1553	1122	2726	4592	5401	9993
91325	72162	35957	1477	914	2478	36205	2007	1116	3167	4869	6290	11159
91326	38554	18631	1124	855	1513	19923	1338	1026	1922	3492	4286	7778
91327	3102	1405	90	91	131	1697	79	67	168	312	314	626
91328	5791	3060	88	101	276	2731	158	79	133	465	370	835
91329	4069	1996	98	107	119	2073	147	47	265	324	459	783
91330	9159	4458	88	101	280	4701	161	79	133	469	373	842
91331	117128	59032	2486	1426	2541	58096	2424	2054	4038	6453	8516	14969
91333	2021	1158	42	33	39	863	37	35	52	114	124	238
91334	5612	2839	124	42	164	2773	105	92	246	330	443	773
91335	65296	31574	1269	771	1764	33722	1268	1118	3302	3804	5688	9492
91337	4667	2358	94	82	116	2309	105	87	121	292	313	605
91340	45969	22596	955	618	816	23373	933	656	1281	2389	2870	5259
91341	5020	2446	88	77	69	2574	113	77	163	234	353	587
91342	98687	49447	2116	1323	2377	49240	2404	1662	3178	5816	7244	13060
91343	54361	27347	894	803	1197	27014	1178	818	1851	2894	3847	6741
91344	57087	27815	1472	1195	2114	29272	1814	1380	2911	4781	6105	10886
91345	27659	13355	676	508	820	14304	823	719	1389	2004	2931	4935
91346	2777	1342	91	70	51	1435	96	129	149	212	374	586
91350	57470	27712	1342	1025	1243	29758	1509	1136	2254	3610	4899	8509
91351	57243	27417	1083	990	1218	29826	1588	1204	1912	3291	4704	7995
91352	59127	28526	1494	845	1284	30601	1367	1085	2138	3623	4590	8213
91353	1768	771	20	17	21	997	26	30	74	58	130	188
91354	31462	15290	610	446	455	16172	590	496	876	1511	1962	3473
91355	55604	27380	1232	702	1139	28224	1252	861	1741	3073	3854	6927
91356	36828	17635	1171	821	1664	19193	1425	727	1974	3656	4126	7782
91357	2586	1269	26	20	148	1317	70	20	150	194	240	434
91361	7119	3448	354	286	339	3671	378	231	516	979	1125	2104
91362	6022	2975	215	93	134	3047	173	110	162	442	445	887
91364	40832	19841	1586	904	1871	20991	1208	1098	2195	4361	4501	8862
91365	3300	1587	106	56	161	1713	80	69	147	323	296	619
91367	58913	28461	1874	1077	2338	30452	1700	1480	3274	5289	6454	11743
91371	3110	1360	26	82	15	1750	42	140	72	123	254	377
91372	3839	1669	221	114	158	2170	130	164	202	493	496	989
91376	4542	2184	89	64	128	2358	129	59	118	281	306	587
91380	3160	1524	68	29	56	1636	41	83	123	153	247	400
91381	14669	7136	238	206	146	7533	241	242	432	590	915	1505
91383	2527	1233	83	11	5	1294	64	15	26	99	105	204
91384	30300	18221	485	238	306	12079	371	239	542	1029	1152	2181
91385	5201	2530	153	92	227	2671	233	153	337	472	723	1195
91386	4653	2177	204	188	382	2476	199	191	720	774	1110	1884
91387	37648	18308	599	511	604	19340	1160	625	824	1714	2609	4323
91390	42402	21405	1015	828	856	20997	1104	637	1114	2699	2855	5554
91392	4338	2125	58	112	9	2213	171	16	40	179	227	406
91393	2745	1262	23	7	18	1483	26	36	21	48	83	131
91394	6631	3002	152	0	72	3629	155	90	197	224	442	666
91395	3399	1463	54	16	55	1936	100	58	165	125	323	448
91396	4920	2836	104	88	211	2084	139	83	154	403	376	779
91401	58129	28295	1153	570	1171	29834	1596	679	2184	2894	4459	7353
91402	69111	34414	1142	753	1178	34697	1257	1024	1941	3073	4222	7295
91403	41349	19712	1031	807	1617	21637	1525	716	2073	3455	4314	7769
91404	2435	1224	59	2	33	1211	15	54	36	94	105	199
91405	53861	26888	1024	609	876	26973	1245	636	1942	2509	3823	6332
91406	46708	23184	872	638	1065	23524	1118	834	1500	2575	3452	6027
91407	2435	1224	59	2	33	1211	15	54	36	94	105	199
91408	2435	1224	59	2	33	1211	15	54	36	94	105	199
91409	2153	914	15	16	197	1239	8	28	183	228	219	447
91411	25587	12662	559	272	393	12925	587	277	996	1224	1860	3084
91412	2014	885	27	15	10	1129	35	13	66	52	114	166
91413	3440	1862	82	62	68	1578	61	102	70	212	233	445
91416	4540	2083	97	61	50	2457	236	33	119	208	388	596
91423	48620	23301	1290	735	1189	25319	1364	840	2103	3214	4307	7521
91426	4540	2083	97	61	50	2457	236	33	119	208	388	596
91436	15337	7419	623	606	1063	7918	595	375	1117	2292	2087	4379
91470	2153	914	15	16	197	1239	8	28	183	228	219	447
91482	2153	914	15	16	197	1239	8	28	183	228	219	447
91495	3440	1862	82	62	68	1578	61	102	70	212	233	445
91496	3440	1862	82	62	68	1578	61	102	70	212	233	445
91501	31031	14248	519	581	1338	16783	989	798	2224	2438	4011	6449
91502	36053	17397	579	564	1246	18656	941	866	2101	2389	3908	6297
91503	6457	2834	13	95	376	3623	211	235	538	484	984	1468
91504	24476	11619	406	461	1014	12857	683	523	1165	1881	2371	4252
91505	55888	26984	1315	1118	1380	28904	1578	1146	2274	3813	4998	8811
91506	26197	12459	601	547	707	13738	944	597	1288	1855	2829	4684
91507	3225	1515	97	13	88	1710	108	109	135	198	352	550
91508	5271	2455	0	103	110	2816	18	163	192	213	373	586
91510	3225	1515	97	13	88	1710	108	109	135	198	352	550
91521	4861	2105	178	154	191	2756	311	94	387	523	792	1315
91522	6267	2980	123	68	108	3287	111	59	114	299	284	583
91523	6267	2980	123	68	108	3287	111	59	114	299	284	583
91601	45527	23106	694	501	708	22421	733	699	1153	1903	2585	4488
91602	26904	13102	614	367	431	13802	620	306	725	1412	1651	3063
91603	5125	2531	58	10	150	2594	45	164	155	218	364	582
91604	45228	22203	958	570	1074	23025	1079	586	1849	2602	3514	6116
91605	68594	33249	1471	855	1326	35345	1537	1244	2136	3652	4917	8569
91606	68457	34676	1263	883	1704	33781	1396	1185	2368	3850	4949	8799
91607	40583	19658	864	521	844	20925	891	863	1626	2229	3380	5609
91608	3200	1875	121	23	132	1325	55	31	172	276	258	534
91609	1695	876	31	11	81	819	30	0	38	123	68	191
91610	3937	1854	155	99	69	2083	158	67	62	323	287	610
91611	3399	1769	50	120	37	1630	76	75	78	207	229	436
91612	3399	1769	50	120	37	1630	76	75	78	207	229	436
91614	3363	1708	151	150	107	1655	163	26	141	408	330	738
91615	2695	1354	80	10	54	1341	44	0	25	144	69	213
91617	4052	1840	136	73	113	2212	116	128	147	322	391	713
91702	53071	25708	939	717	920	27363	1156	814	1469	2576	3439	6015
91706	75777	37282	1719	1095	1380	38495	2119	1409	2393	4194	5921	10115
91709	5001	2453	110	107	65	2548	145	82	128	282	355	637
91710	2795	1374	3	21	74	1421	55	30	92	98	177	275
91711	45670	21979	1312	1116	1799	23691	1695	984	2630	4227	5309	9536
91715	1613	848	7	22	37	765	39	14	50	66	103	169
91722	52105	24897	1061	924	1360	27208	1351	894	1997	3345	4242	7587
91723	29376	14197	679	663	963	15179	740	386	1499	2305	2625	4930
91724	43326	20946	1169	1152	1528	22380	1242	797	2400	3849	4439	8288
91731	48493	24173	1202	991	1733	24320	1631	951	2277	3926	4859	8785
91732	60434	29557	1348	1137	1503	30877	1462	1116	2255	3988	4833	8821
91733	48792	24090	956	718	1340	24702	1310	864	1993	3014	4167	7181
91734	5095	2489	194	83	210	2606	241	49	166	487	456	943
91740	40750	19608	857	763	1248	21142	1131	824	2190	2868	4145	7013
91741	34522	16016	841	704	954	18506	1041	782	1556	2499	3379	5878
91744	102920	50349	2091	1634	2479	52571	2576	1867	3782	6204	8225	14429
91745	57120	27280	1690	1107	2293	29840	2037	1373	2992	5090	6402	11492
91746	43682	21792	1352	746	1288	21890	1254	981	1919	3386	4154	7540
91747	5579	2616	145	54	160	2963	85	125	319	359	529	888
91748	46057	23104	1495	1062	1626	22953	1683	941	1890	4183	4514	8697
91750	54896	26741	1826	1436	1826	28155	1970	1274	3096	5088	6340	11428
91754	44945	21283	1164	1129	2484	23662	1409	1380	3087	4777	5876	10653
91755	34090	16349	937	803	1346	17741	1242	765	2106	3086	4113	7199
91756	4038	1967	169	126	145	2071	153	91	168	440	412	852
91765	56374	26828	1706	1148	1328	29546	1958	1306	2091	4182	5355	9537
91766	55972	26950	869	603	957	29022	1099	780	1579	2429	3458	5887
91767	55146	26626	1065	710	1286	28520	1265	973	2277	3061	4515	7576
91768	44301	21770	887	716	1065	22531	885	610	1458	2668	2953	5621
91769	2993	1389	22	17	41	1604	24	7	26	80	57	137
91770	64947	31513	1680	1479	2099	33434	1980	1551	3519	5258	7050	12308
91771	3376	1737	140	44	94	1639	55	53	220	278	328	606
91772	3376	1737	140	44	94	1639	55	53	220	278	328	606
91773	49610	23604	1536	1081	1569	26006	1827	1138	2732	4186	5697	9883
91775	47505	22379	1307	845	2095	25126	1452	1417	2856	4247	5725	9972
91776	57382	27378	1282	1094	2099	30004	1584	1529	3081	4475	6194	10669
91778	3396	1607	62	32	112	1789	55	74	292	206	421	627
91780	47879	22675	1254	722	1891	25204	1612	1320	2641	3867	5573	9440
91786	3949	1823	4	0	4	2126	4	0	10	8	14	22
91788	3063	1391	65	52	70	1672	76	92	140	187	308	495
91789	57462	27937	1845	1128	1552	29525	2051	1384	2184	4525	5619	10144
91790	58402	28406	1225	922	1779	29996	1531	1062	2659	3926	5252	9178
91791	48264	23550	1104	917	1705	24714	1359	724	2728	3726	4811	8537
91792	39058	18866	1109	672	910	20192	1343	777	1296	2691	3416	6107
91793	5024	2385	107	56	138	2639	174	123	236	301	533	834
91801	59115	28304	1187	965	1729	30811	1597	1391	2974	3881	5962	9843
91802	3434	1577	182	56	201	1857	18	50	475	439	543	982
91803	42598	21047	1157	858	1618	21551	1322	924	2316	3633	4562	8195
93063	3296	1584	175	104	129	1712	228	108	177	408	513	921
93243	1084	560	48	35	54	524	41	25	23	137	89	226
93510	10558	5631	348	398	181	4927	399	205	332	927	936	1863
93532	9662	4965	306	154	249	4697	211	147	303	709	661	1370
93534	65401	31155	1453	1219	1538	34246	1883	1144	2378	4210	5405	9615
93535	55343	25914	880	1043	979	29429	1346	816	1271	2902	3433	6335
93536	67921	35966	1475	1067	1493	31955	1667	1221	2236	4035	5124	9159
93539	2971	1438	57	69	97	1533	57	48	174	223	279	502
93543	19672	9665	448	355	548	10007	603	436	619	1351	1658	3009
93544	8626	4411	369	281	312	4215	327	280	337	962	944	1906
93550	66292	32220	982	834	1305	34072	1257	969	1911	3121	4137	7258
93551	54153	26486	1275	760	1359	27667	1418	1069	1911	3394	4398	7792
93552	40133	19925	792	488	690	20208	896	712	964	1970	2572	4542
93553	9861	4993	281	265	373	4868	338	223	380	919	941	1860
93560	3059	1600	107	54	103	1459	86	67	166	264	319	583
93563	4303	2191	138	199	201	2112	134	157	260	538	551	1089
93586	3829	1778	54	27	105	2051	53	101	145	186	299	485
93591	19251	9666	636	418	466	9585	664	451	561	1520	1676	3196
93599	11	11	0	0	0	0	0	0	0	0	0	0
